BBBBBBBBBBBBBBB
B             B
B     B B     B
B     B B     B
B     B B     B
B     B B     B
B BBBBB BBBBB B
B             B
B BBBBB BBBBB B
B     B B     B
B     B B     B
B     B B     B
B     B B     B
B             B
BBBBBBBBBBBBBBB