BBBBBBBBBBBBBBBBBBBBBBB
B CCCCCCCCCBCCCCCCCCCCB
BCBBBCBBBBCBCBBBBCBBBCB
BCBBBCBBBBCBCBBBBCBBBCB
BCCCCPCCCCCCCCCCCPCCCCB
BCBBBCBCBBBBBBBCBCBBBCB
BCCCCCBCCCCBCCCCBCCCCCB
BCBBBCBBBBCBCBBBBCBBBCB
BCBBBCB         BCBBBCB
BCBBBCB BBB BBB BCBBBCB
BPCCCC  BBBEBBB  PCCCCB     
BCBBBCB BBB BBB BCBBBCB
BCBBBCB         BCBBBCB
BCBBBCB BBBBBBB BCBBBCB    
BCBBBCBCBBBBBBBCBCBBBCB
BCCCCCCCCCCBCCCCCCCCCCB
BCBBBCBBBBCBCBBBBCBBBCB
BPCCBCCCCCCCCCCCCCBCCPB
BBBCBCBCBBBBBBBCBCBCBBB
BCCCCCBCCCCBCCCCBCCCCCB
BCBBBBBBBBCBCBBBBBBBBCB
BCCCCCCCCCCCCCCCCCCCCCB
BBBBBBBBBBBBBBBBBBBBBBB